missing_days
2025-07-01
2025-07-02
2025-07-03
2025-07-04
2025-07-06
2025-07-07
2025-07-08
2025-07-10
2025-07-11
2025-07-12
2025-07-13
2025-07-14
2025-07-15
2025-07-16
2025-07-17
2025-07-18
2025-07-19
2025-07-20
2025-07-21
2025-07-22
2025-07-23
2025-07-24
2025-07-25
2025-07-26
2025-07-27
2025-07-28
2025-07-29
2025-07-30
2025-07-31
